20 17
.....T..X...G....
.XX.XXX.X.XXX.XX.
.XX.XXX...XXX.XX.
.................
.XX.X.XXXXX.X.XX.
.G..X...X...X....
XXX.XXX.X.XXX.XXX
XXX.X.......X.XXX
.G..X.XX.XX.X....
XXX...XG..X...XXX
XXX.X.XXXXX.X.XXX
XXX.X.......X.XXX
XXX.X.XXXXX.X.XXX
........X........
.XX.XXX.X.XXX.XX.
..X.....X.S...X..
X.X.X.X.X.X.X.X.X
......X...X......
.XXXXXXX.XXXXXXX.
.................