9 10
.......T..
GXX.XX.X.X
....XX.X.X
XXX.XX.X.X
XXX.XX...X
....XG.XXX
.XXX..XXXX
.XXX.XXXXX
.S...XXXXX